.w.w.w.w
w.w.w.w.
.w.w.w.w
........
........
b.b.b.b.
.b.b.b.b
b.b.b.b.